#domain
hospital
#levelname
46
#colors
red: 0, A, C
blue: 1, B, D
#initial
++++++++++++
+        10+
+  + +++++++
+  +       +
+  +       +
+BD+ +++++++
+CA+       +
++++++++++++
#goal
++++++++++++
+          +
+  + +++++++
+  +       +
+  +     01+
+  + +++++++
+  +ABCD   +
++++++++++++
#end
