#domain
hospital
#levelname
Group80
#colors
cyan: 0, A, F
blue: 1, B
red:  2, C, Z
#initial
+++++++++ ++++++++
+       +++      +
+  + +      ++   +
+  +A+0 +++++    +
+ 1+B+  +     +  +
+  +C+2Z++++++++ +
+++++++++     F  +
++++++++++++++++++
#goal
+++++++++ ++++++++
+       +++     F+
+  + +      ++   +
+  +C+  +++++    +
+  +B+  +1    +  +
+  +A+  ++++++++ +
+++++++++0       +
++++++++++++++++++
#end
