#domain
hospital
#levelname
MAbfsfriendly.lvl
#colors
blue: 0,1,2,3
#initial
+++++++++++++
+0+    +   3+
+      + ++++
+ ++++++    +
+      + ++ +
+         + +
+++++     + +
+   +     + +
+   + +   + +
+     +   + +
+         + +
+2    +   +1+
+++++++++++++
#goal
+++++++++++++
+ +    +    +
+     0+ ++++
+ ++++++  31+
+      + ++ +
+         + +
+++++     + +
+  2+     + +
+   + +   + +
+     +   + +
+         + +
+     +   + +
+++++++++++++
#end
