#domain
hospital
#levelname
MAsimple1
#colors
red: 0, A
green: 1, B
#initial
++++++++++++++++++++++++++++
+        A    0            +
+     1                B   +
+ +++++++++++++++++        +
+                          +
++++++++++++++++++++++++++++
#goal
++++++++++++++++++++++++++++
+                       A  +
+                       B  +
+ +++++++++++++++++        +
+                          +
++++++++++++++++++++++++++++
#end
